{
    "_comment": "Vanilla Java Edition map base colors (ids 1-61). mcmm applies the 4 vanilla shades {180,220,255,135} as id*4+shade, producing standard map color bytes that render on any client without a mod. Id 0 (NONE/transparent) is intentionally omitted so dark pixels never become transparent.",
    "colorList": {
        "1": "#7fb238",
        "2": "#f7e9a3",
        "3": "#c7c7c7",
        "4": "#ff0000",
        "5": "#a0a0ff",
        "6": "#a7a7a7",
        "7": "#007c00",
        "8": "#ffffff",
        "9": "#a4a8b8",
        "10": "#976d4d",
        "11": "#707070",
        "12": "#4040ff",
        "13": "#8f7748",
        "14": "#fffcf5",
        "15": "#d87f33",
        "16": "#b24cd8",
        "17": "#6699d8",
        "18": "#e5e533",
        "19": "#7fcc19",
        "20": "#f27fa5",
        "21": "#4c4c4c",
        "22": "#999999",
        "23": "#4c7f99",
        "24": "#7f3fb2",
        "25": "#334cb2",
        "26": "#664c33",
        "27": "#667f33",
        "28": "#993333",
        "29": "#191919",
        "30": "#faee4d",
        "31": "#5cdbd5",
        "32": "#4a80ff",
        "33": "#00d93a",
        "34": "#815631",
        "35": "#700200",
        "36": "#d1b1a1",
        "37": "#9f5224",
        "38": "#95576c",
        "39": "#706c8a",
        "40": "#ba8524",
        "41": "#677535",
        "42": "#a04d4e",
        "43": "#392923",
        "44": "#876b62",
        "45": "#575c5c",
        "46": "#7a4958",
        "47": "#4c3e5c",
        "48": "#4c3223",
        "49": "#4c522a",
        "50": "#8e3c2e",
        "51": "#251610",
        "52": "#bd3031",
        "53": "#943f61",
        "54": "#5c191d",
        "55": "#167e86",
        "56": "#3a8e8c",
        "57": "#562c3e",
        "58": "#14b485",
        "59": "#646464",
        "60": "#d8af93",
        "61": "#7fa796"
    }
}
